6 7 2 9 8 4 5 3 1
8 3 1 2 5 7 6 4 9
5 4 9 6 1 3 8 2 7
1 5 7 8 3 2 4 9 6
3 9 6 7 4 5 2 1 8
2 8 4 1 9 6 7 5 3
4 1 5 3 7 8 9 6 2
9 2 8 5 6 1 3 7 4
7 6 3 4 2 9 1 8 5
