3 5 1 4 8 9 6 2 7
4 6 9 7 5 2 8 1 3
2 8 7 3 1 6 5 9 4
9 4 6 2 3 8 1 7 5
1 2 8 5 4 7 3 6 9
5 7 3 6 9 1 2 4 8
6 9 2 8 7 3 4 5 1
7 3 4 1 6 5 9 8 2
8 1 5 9 2 4 7 3 6