9 4 6 8 3 2 1 5 7
1 2 8 7 4 5 3 9 6
5 7 3 1 9 6 2 8 4
8 1 5 4 2 9 7 6 3
6 9 2 3 7 8 4 1 5
7 3 4 5 6 1 9 2 8
3 5 1 9 8 4 6 7 2
4 6 9 2 5 7 8 3 1
2 8 7 6 1 3 5 4 9