0 7 0 9 0 4 5 0 1
0 0 0 0 0 7 6 0 0
0 0 0 6 1 3 0 0 7
0 5 7 0 0 2 0 9 6
3 0 6 7 0 5 2 0 0
0 8 0 1 9 0 7 0 0
0 1 0 0 0 0 0 6 2
9 2 8 5 0 1 0 0 4
0 6 0 4 0 0 0 8 5


