0 5 0 0 0 0 0 0 0
4 0 0 0 0 2 0 0 3
0 0 0 0 0 6 0 9 4
0 0 6 2 3 0 1 7 0
1 0 8 5 4 7 3 0 9
5 0 3 6 0 0 0 0 8
0 0 0 8 0 0 0 0 0
0 0 0 1 6 0 0 0 0
0 1 0 0 0 4 7 3 0